BIBEXTRACT
BIBT
BINDIR
Bi
BibTeX
Email
FAX
LIBDIR
LaTeX
Te
TeX
aeiou
beebe
bibclean
bibextract
bibextract.awk
bibfile
bibindex
biblook
bibsort
bibtex
citefind
citetags
math.utah.edu
nawk
regexp
v'0.15v'T
v'0.20v'E
