BIBT
BINDIR
Bi
BibTeX
CITEFIND
Email
FAX
LIBDIR
Te
TeX
beebe
bibclean
bibextract
bibfile
bibindex
biblook
bibsort
bibtex
citefind
citefind.awk
citetags
math.utah.edu
nawk
newbibfile
