BIBT
BINDIR
Bi
BibTeX
CITETAGS
Email
FAX
LIBDIR
LaTeX
Te
TeX
aux
beebe
bibclean
bibextract
bibindex
biblook
bibsort
bibtex
citefind
citetags
citetags.awk
math.utah.edu
nawk
tagsfile
v'0.15v'T
v'0.20v'E
